P_Ac_in (W),P_Batt_in (W),P_loss_in,,P_Ac_out,P_Batt_out,P_loss_out
0,0,0,,0,0,0
-36,-72,0,,36,36,0
-72,-144,0,,72,72,0
-108,-216,0,,108,108,0
-144,-288,0,,144,144,0
-180,-360,0,,180,180,0
-216,-432,0,,216,216,0
-252,-504,0,,252,504,0
-288,-576,0,,288,576,0
-324,-648,0,,324,648,0
-360,-720,0,,360,720,0
-396,-792,0,,396,792,0
-432,-864,0,,432,864,0
-468,-936,0,,468,936,0
-504,-1008,0,,504,1008,0
-540,-1080,0,,540,1080,0
-576,-1152,0,,576,1152,0
-612,-1224,0,,612,1224,0
-648,-1296,0,,648,1296,0
-684,-1368,0,,684,1368,0
-720,-1440,0,,720,1440,0
-756,-1512,0,,756,1512,0
-792,-1584,0,,792,1584,0
-828,-1656,0,,828,1656,0
-864,-1728,0,,864,1728,0
-900,-1800,0,,900,1800,0
-936,-1872,0,,936,1872,0
-972,-1944,0,,972,1944,0
-1008,-2016,0,,1008,2016,0
-1044,-2088,0,,1044,2088,0
-1080,-2160,0,,1080,2160,0
-1116,-2232,0,,1116,2232,0
-1152,-2304,0,,1152,2304,0
-1188,-2376,0,,1188,2376,0
-1224,-2448,0,,1224,2448,0
-1260,-2520,0,,1260,2520,0
-1296,-2592,0,,1296,2592,0
-1332,-2664,0,,1332,2664,0
-1368,-2736,0,,1368,2736,0
-1404,-2808,0,,1404,2808,0
-1440,-2880,0,,1440,2880,0
-1476,-2952,0,,1476,2952,0
-1512,-3024,0,,1512,3024,0
-1548,-3096,0,,1548,3096,0
-1584,-3168,0,,1584,3168,0
-1620,-3240,0,,1620,3240,0
-1656,-3312,0,,1656,3312,0
-1692,-3384,0,,1692,3384,0
-1728,-3456,0,,1728,3456,0
-1764,-3528,0,,1764,3528,0
-1800,-3600,0,,1800,3600,0
-1836,-3672,0,,1836,3672,0
-1872,-3744,0,,1872,3744,0
-1908,-3816,0,,1908,3816,0
-1944,-3888,0,,1944,3888,0
-1980,-3960,0,,1980,3960,0
-2016,-4032,0,,2016,4032,0
-2052,-4104,0,,2052,4104,0
-2088,-4176,0,,2088,4176,0
-2124,-4248,0,,2124,4248,0
-2160,-4320,0,,2160,4320,0
-2196,-4392,0,,2196,4392,0
-2232,-4464,0,,2232,4464,0
-2268,-4536,0,,2268,4536,0
-2304,-4608,0,,2304,4608,0
-2340,-4680,0,,2340,4680,0
-2376,-4752,0,,2376,4752,0
-2412,-4824,0,,2412,4824,0
-2448,-4896,0,,2448,4896,0
-2484,-4968,0,,2484,4968,0
-2520,-5040,0,,2520,5040,0
-2556,-5112,0,,2556,5112,0
-2592,-5184,0,,2592,5184,0
-2628,-5256,0,,2628,5256,0
-2664,-5328,0,,2664,5328,0
-2700,-5400,0,,2700,5400,0
-2736,-5472,0,,2736,5472,0
-2772,-5544,0,,2772,5544,0
-2808,-5616,0,,2808,5616,0
-2844,-5688,0,,2844,5688,0
-2880,-5760,0,,2880,5760,0
-2916,-5832,0,,2916,5832,0
-2952,-5904,0,,2952,5904,0
-2988,-5976,0,,2988,5976,0
-3024,-6048,0,,3024,6048,0
-3060,-6120,0,,3060,6120,0
-3096,-6192,0,,3096,6192,0
-3132,-6264,0,,3132,6264,0
-3168,-6336,0,,3168,6336,0
-3204,-6408,0,,3204,6408,0
-3240,-6480,0,,3240,6480,0
-3276,-6552,0,,3276,6552,0
-3312,-6624,0,,3312,6624,0
-3348,-6696,0,,3348,6696,0
-3384,-6768,0,,3384,6768,0
-3420,-6840,0,,3420,6840,0
-3456,-6912,0,,3456,6912,0
-3492,-6984,0,,3492,6984,0
-3528,-7056,0,,3528,7056,0
-3564,-7128,0,,3564,7128,0
-3600,-7200,0,,3600,7200,0
-3636,-7272,0,,3636,7272,0
-3672,-7344,0,,3672,7344,0
-3708,-7416,0,,3708,7416,0
-3744,-7488,0,,3744,7488,0
-3780,-7560,0,,3780,7560,0
-3816,-7632,0,,3816,7632,0
-3852,-7704,0,,3852,7704,0
-3888,-7776,0,,3888,7776,0
-3924,-7848,0,,3924,7848,0
-3960,-7920,0,,3960,7920,0
-3996,-7992,0,,3996,7992,0
-4032,-8064,0,,4032,8064,0
-4068,-8136,0,,4068,8136,0
-4104,-8208,0,,4104,8208,0
-4140,-8280,0,,4140,8280,0
-4176,-8352,0,,4176,8352,0
-4212,-8424,0,,4212,8424,0
-4248,-8496,0,,4248,8496,0
-4284,-8568,0,,4284,8568,0
-4320,-8640,0,,4320,8640,0
-4356,-8712,0,,4356,8712,0
-4392,-8784,0,,4392,8784,0
-4428,-8856,0,,4428,8856,0
-4464,-8928,0,,4464,8928,0
-4500,-9000,0,,4500,9000,0
-4536,-9072,0,,4536,9072,0
-4572,-9144,0,,4572,9144,0
-4608,-9216,0,,4608,9216,0
-4644,-9288,0,,4644,9288,0
-4680,-9360,0,,4680,9360,0
-4716,-9432,0,,4716,9432,0
-4752,-9504,0,,4752,9504,0
-4788,-9576,0,,4788,9576,0
-4824,-9648,0,,4824,9648,0
-4860,-9720,0,,4860,9720,0
-4896,-9792,0,,4896,9792,0
-4932,-9864,0,,4932,9864,0
-4968,-9936,0,,4968,9936,0
-5004,-10008,0,,5004,10008,0
-5040,-10080,0,,5040,10080,0
-5076,-10152,0,,5076,10152,0
-5112,-10224,0,,5112,10224,0
-5148,-10296,0,,5148,10296,0
-5184,-10368,0,,5184,10368,0
-5220,-10440,0,,5220,10440,0
-5256,-10512,0,,5256,10512,0
-5292,-10584,0,,5292,10584,0
-5328,-10656,0,,5328,10656,0
-5364,-10728,0,,5364,10728,0
-5400,-10800,0,,5400,10800,0
-5436,-10872,0,,5436,10872,0
-5472,-10944,0,,5472,10944,0
-5508,-11016,0,,5508,11016,0
-5544,-11088,0,,5544,11088,0
-5580,-11160,0,,5580,11160,0
-5616,-11232,0,,5616,11232,0
-5652,-11304,0,,5652,11304,0
-5688,-11376,0,,5688,11376,0
-5724,-11448,0,,5724,11448,0
-5760,-11520,0,,5760,11520,0
-5796,-11592,0,,5796,11592,0
-5832,-11664,0,,5832,11664,0
-5868,-11736,0,,5868,11736,0
-5904,-11808,0,,5904,11808,0
-5940,-11880,0,,5940,11880,0
-5976,-11952,0,,5976,11952,0
-6012,-12024,0,,6012,12024,0
-6048,-12096,0,,6048,12096,0
-6084,-12168,0,,6084,12168,0
-6120,-12240,0,,6120,12240,0
-6156,-12312,0,,6156,12312,0
-6192,-12384,0,,6192,12384,0
-6228,-12456,0,,6228,12456,0
-6264,-12528,0,,6264,12528,0
-6300,-12600,0,,6300,12600,0
-6336,-12672,0,,6336,12672,0
-6372,-12744,0,,6372,12744,0
-6408,-12816,0,,6408,12816,0
-6444,-12888,0,,6444,12888,0
-6480,-12960,0,,6480,12960,0
-6516,-13032,0,,6516,13032,0
-6552,-13104,0,,6552,13104,0
-6588,-13176,0,,6588,13176,0
-6624,-13248,0,,6624,13248,0
-6660,-13320,0,,6660,13320,0
-6696,-13392,0,,6696,13392,0
-6732,-13464,0,,6732,13464,0
-6768,-13536,0,,6768,13536,0
-6804,-13608,0,,6804,13608,0
-6840,-13680,0,,6840,13680,0
-6876,-13752,0,,6876,13752,0
-6912,-13824,0,,6912,13824,0
-6948,-13896,0,,6948,13896,0
-6984,-13968,0,,6984,13968,0
-7020,-14040,0,,7020,14040,0
-7056,-14112,0,,7056,14112,0
-7092,-14184,0,,7092,14184,0
-7128,-14256,0,,7128,14256,0
-7164,-14328,0,,7164,14328,0
-7200,-14400,0,,7200,14400,0
-7236,-14472,0,,7236,14472,0
-7272,-14544,0,,7272,14544,0
-7308,-14616,0,,7308,14616,0
-7344,-14688,0,,7344,14688,0
-7380,-14760,0,,7380,14760,0
-7416,-14832,0,,7416,14832,0
-7452,-14904,0,,7452,14904,0
-7488,-14976,0,,7488,14976,0
-7524,-15048,0,,7524,15048,0
-7560,-15120,0,,7560,15120,0
-7596,-15192,0,,7596,15192,0
-7632,-15264,0,,7632,15264,0
-7668,-15336,0,,7668,15336,0
-7704,-15408,0,,7704,15408,0
-7740,-15480,0,,7740,15480,0
-7776,-15552,0,,7776,15552,0
-7812,-15624,0,,7812,15624,0
-7848,-15696,0,,7848,15696,0
-7884,-15768,0,,7884,15768,0
-7920,-15840,0,,7920,15840,0
-7956,-15912,0,,7956,15912,0
-7992,-15984,0,,7992,15984,0
-8028,-16056,0,,8028,16056,0
-8064,-16128,0,,8064,16128,0
-8100,-16200,0,,8100,16200,0
-8136,-16272,0,,8136,16272,0
-8172,-16344,0,,8172,16344,0
-8208,-16416,0,,8208,16416,0
-8244,-16488,0,,8244,16488,0
-8280,-16560,0,,8280,16560,0
-8316,-16632,0,,8316,16632,0
-8352,-16704,0,,8352,16704,0
-8388,-16776,0,,8388,16776,0
-8424,-16848,0,,8424,16848,0
-8460,-16920,0,,8460,16920,0
-8496,-16992,0,,8496,16992,0
-8532,-17064,0,,8532,17064,0
-8568,-17136,0,,8568,17136,0
-8604,-17208,0,,8604,17208,0
-8640,-17280,0,,8640,17280,0
-8676,-17352,0,,8676,17352,0
-8712,-17424,0,,8712,17424,0
-8748,-17496,0,,8748,17496,0
-8784,-17568,0,,8784,17568,0
-8820,-17640,0,,8820,17640,0
-8856,-17712,0,,8856,17712,0
-8892,-17784,0,,8892,17784,0
-8928,-17856,0,,8928,17856,0
-8964,-17928,0,,8964,17928,0
-9000,-18000,0,,9000,18000,0
-9036,-18072,0,,9036,18072,0
-9072,-18144,0,,9072,18144,0
-9108,-18216,0,,9108,18216,0
-9144,-18288,0,,9144,18288,0
-9180,-18360,0,,9180,18360,0
-9216,-18432,0,,9216,18432,0
-9252,-18504,0,,9252,18504,0
-9288,-18576,0,,9288,18576,0
-9324,-18648,0,,9324,18648,0
-9360,-18720,0,,9360,18720,0
-9396,-18792,0,,9396,18792,0
-9432,-18864,0,,9432,18864,0
-9468,-18936,0,,9468,18936,0
-9504,-19008,0,,9504,19008,0
-9540,-19080,0,,9540,19080,0
-9576,-19152,0,,9576,19152,0
-9612,-19224,0,,9612,19224,0
-9648,-19296,0,,9648,19296,0
-9684,-19368,0,,9684,19368,0
-9720,-19440,0,,9720,19440,0
-9756,-19512,0,,9756,19512,0
-9792,-19584,0,,9792,19584,0
-9828,-19656,0,,9828,19656,0
-9864,-19728,0,,9864,19728,0
-9900,-19800,0,,9900,19800,0
-9936,-19872,0,,9936,19872,0
-9972,-19944,0,,9972,19944,0
-10008,-20016,0,,10008,20016,0
-10044,-20088,0,,10044,20088,0
-10080,-20160,0,,10080,20160,0
-10116,-20232,0,,10116,20232,0
-10152,-20304,0,,10152,20304,0
-10188,-20376,0,,10188,20376,0
-10224,-20448,0,,10224,20448,0
-10260,-20520,0,,10260,20520,0
-10296,-20592,0,,10296,20592,0
-10332,-20664,0,,10332,20664,0
-10368,-20736,0,,10368,20736,0
-10404,-20808,0,,10404,20808,0
-10440,-20880,0,,10440,20880,0
-10476,-20952,0,,10476,20952,0
-10512,-21024,0,,10512,21024,0
-10548,-21096,0,,10548,21096,0
-10584,-21168,0,,10584,21168,0
-10620,-21240,0,,10620,21240,0
-10656,-21312,0,,10656,21312,0
-10692,-21384,0,,10692,21384,0
-10728,-21456,0,,10728,21456,0
-10764,-21528,0,,10764,21528,0
-10800,-21600,0,,10800,21600,0
-10836,-21672,0,,10836,21672,0
-10872,-21744,0,,10872,21744,0
-10908,-21816,0,,10908,21816,0
-10944,-21888,0,,10944,21888,0
-10980,-21960,0,,10980,21960,0
-11016,-22032,0,,11016,22032,0
-11052,-22104,0,,11052,22104,0
-11088,-22176,0,,11088,22176,0
-11124,-22248,0,,11124,22248,0
-11160,-22320,0,,11160,22320,0
-11196,-22392,0,,11196,22392,0
-11232,-22464,0,,11232,22464,0
-11268,-22536,0,,11268,22536,0
-11304,-22608,0,,11304,22608,0
-11340,-22680,0,,11340,22680,0
-11376,-22752,0,,11376,22752,0
-11412,-22824,0,,11412,22824,0
-11448,-22896,0,,11448,22896,0
-11484,-22968,0,,11484,22968,0
-11520,-23040,0,,11520,23040,0
-11556,-23112,0,,11556,23112,0
-11592,-23184,0,,11592,23184,0
-11628,-23256,0,,11628,23256,0
-11664,-23328,0,,11664,23328,0
-11700,-23400,0,,11700,23400,0
-11736,-23472,0,,11736,23472,0
-11772,-23544,0,,11772,23544,0
-11808,-23616,0,,11808,23616,0
-11844,-23688,0,,11844,23688,0
-11880,-23760,0,,11880,23760,0
-11916,-23832,0,,11916,23832,0
-11952,-23904,0,,11952,23904,0
-11988,-23976,0,,11988,23976,0
-12024,-24048,0,,12024,24048,0
-12060,-24120,0,,12060,24120,0
-12096,-24192,0,,12096,24192,0
-12132,-24264,0,,12132,24264,0
-12168,-24336,0,,12168,24336,0
-12204,-24408,0,,12204,24408,0
-12240,-24480,0,,12240,24480,0
-12276,-24552,0,,12276,24552,0
-12312,-24624,0,,12312,24624,0
-12348,-24696,0,,12348,24696,0
-12384,-24768,0,,12384,24768,0
-12420,-24840,0,,12420,24840,0
-12456,-24912,0,,12456,24912,0
-12492,-24984,0,,12492,24984,0
-12528,-25056,0,,12528,25056,0
-12564,-25128,0,,12564,25128,0
-12600,-25200,0,,12600,25200,0
-12636,-25272,0,,12636,25272,0
-12672,-25344,0,,12672,25344,0
-12708,-25416,0,,12708,25416,0
-12744,-25488,0,,12744,25488,0
-12780,-25560,0,,12780,25560,0
-12816,-25632,0,,12816,25632,0
-12852,-25704,0,,12852,25704,0
-12888,-25776,0,,12888,25776,0
-12924,-25848,0,,12924,25848,0
-12960,-25920,0,,12960,25920,0
-12996,-25992,0,,12996,25992,0
-13032,-26064,0,,13032,26064,0
-13068,-26136,0,,13068,26136,0
-13104,-26208,0,,13104,26208,0
-13140,-26280,0,,13140,26280,0
-13176,-26352,0,,13176,26352,0
-13212,-26424,0,,13212,26424,0
-13248,-26496,0,,13248,26496,0
-13284,-26568,0,,13284,26568,0
-13320,-26640,0,,13320,26640,0
-13356,-26712,0,,13356,26712,0
-13392,-26784,0,,13392,26784,0
-13428,-26856,0,,13428,26856,0
-13464,-26928,0,,13464,26928,0
-13500,-27000,0,,13500,27000,0
-13536,-27072,0,,13536,27072,0
-13572,-27144,0,,13572,27144,0
-13608,-27216,0,,13608,27216,0
-13644,-27288,0,,13644,27288,0
-13680,-27360,0,,13680,27360,0
-13716,-27432,0,,13716,27432,0
-13752,-27504,0,,13752,27504,0
-13788,-27576,0,,13788,27576,0
-13824,-27648,0,,13824,27648,0
-13860,-27720,0,,13860,27720,0
-13896,-27792,0,,13896,27792,0
-13932,-27864,0,,13932,27864,0
-13968,-27936,0,,13968,27936,0
-14004,-28008,0,,14004,28008,0
-14040,-28080,0,,14040,28080,0
-14076,-28152,0,,14076,28152,0
-14112,-28224,0,,14112,28224,0
-14148,-28296,0,,14148,28296,0
-14184,-28368,0,,14184,28368,0
-14220,-28440,0,,14220,28440,0
-14256,-28512,0,,14256,28512,0
-14292,-28584,0,,14292,28584,0
-14328,-28656,0,,14328,28656,0
-14364,-28728,0,,14364,28728,0
-14400,-28800,0,,14400,28800,0
-14436,-28872,0,,14436,28872,0
-14472,-28944,0,,14472,28944,0
-14508,-29016,0,,14508,29016,0
-14544,-29088,0,,14544,29088,0
-14580,-29160,0,,14580,29160,0
-14616,-29232,0,,14616,29232,0
-14652,-29304,0,,14652,29304,0
-14688,-29376,0,,14688,29376,0
-14724,-29448,0,,14724,29448,0
-14760,-29520,0,,14760,29520,0
-14796,-29592,0,,14796,29592,0
-14832,-29664,0,,14832,29664,0
-14868,-29736,0,,14868,29736,0
-14904,-29808,0,,14904,29808,0
-14940,-29880,0,,14940,29880,0
-14976,-29952,0,,14976,29952,0
-15012,-30024,0,,15012,30024,0
-15048,-30096,0,,15048,30096,0
-15084,-30168,0,,15084,30168,0
-15120,-30240,0,,15120,30240,0
-15156,-30312,0,,15156,30312,0
-15192,-30384,0,,15192,30384,0
-15228,-30456,0,,15228,30456,0
-15264,-30528,0,,15264,30528,0
-15300,-30600,0,,15300,30600,0
-15336,-30672,0,,15336,30672,0
-15372,-30744,0,,15372,30744,0
-15408,-30816,0,,15408,30816,0
-15444,-30888,0,,15444,30888,0
-15480,-30960,0,,15480,30960,0
-15516,-31032,0,,15516,31032,0
-15552,-31104,0,,15552,31104,0
-15588,-31176,0,,15588,31176,0
-15624,-31248,0,,15624,31248,0
-15660,-31320,0,,15660,31320,0
-15696,-31392,0,,15696,31392,0
-15732,-31464,0,,15732,31464,0
-15768,-31536,0,,15768,31536,0
-15804,-31608,0,,15804,31608,0
-15840,-31680,0,,15840,31680,0
-15876,-31752,0,,15876,31752,0
-15912,-31824,0,,15912,31824,0
-15948,-31896,0,,15948,31896,0
-15984,-31968,0,,15984,31968,0
-16020,-32040,0,,16020,32040,0
-16056,-32112,0,,16056,32112,0
-16092,-32184,0,,16092,32184,0
-16128,-32256,0,,16128,32256,0
-16164,-32328,0,,16164,32328,0
-16200,-32400,0,,16200,32400,0
-16236,-32472,0,,16236,32472,0
-16272,-32544,0,,16272,32544,0
-16308,-32616,0,,16308,32616,0
-16344,-32688,0,,16344,32688,0
-16380,-32760,0,,16380,32760,0
-16416,-32832,0,,16416,32832,0
-16452,-32904,0,,16452,32904,0
-16488,-32976,0,,16488,32976,0
-16524,-33048,0,,16524,33048,0
-16560,-33120,0,,16560,33120,0
-16596,-33192,0,,16596,33192,0
-16632,-33264,0,,16632,33264,0
-16668,-33336,0,,16668,33336,0
-16704,-33408,0,,16704,33408,0
-16740,-33480,0,,16740,33480,0
-16776,-33552,0,,16776,33552,0
-16812,-33624,0,,16812,33624,0
-16848,-33696,0,,16848,33696,0
-16884,-33768,0,,16884,33768,0
-16920,-33840,0,,16920,33840,0
-16956,-33912,0,,16956,33912,0
-16992,-33984,0,,16992,33984,0
-17028,-34056,0,,17028,34056,0
-17064,-34128,0,,17064,34128,0
-17100,-34200,0,,17100,34200,0
-17136,-34272,0,,17136,34272,0
-17172,-34344,0,,17172,34344,0
-17208,-34416,0,,17208,34416,0
-17244,-34488,0,,17244,34488,0
-17280,-34560,0,,17280,34560,0
-17316,-34632,0,,17316,34632,0
-17352,-34704,0,,17352,34704,0
-17388,-34776,0,,17388,34776,0
-17424,-34848,0,,17424,34848,0
-17460,-34920,0,,17460,34920,0
-17496,-34992,0,,17496,34992,0
-17532,-35064,0,,17532,35064,0
-17568,-35136,0,,17568,35136,0
-17604,-35208,0,,17604,35208,0
-17640,-35280,0,,17640,35280,0
-17676,-35352,0,,17676,35352,0
-17712,-35424,0,,17712,35424,0
-17748,-35496,0,,17748,35496,0
-17784,-35568,0,,17784,35568,0
-17820,-35640,0,,17820,35640,0
-17856,-35712,0,,17856,35712,0
-17892,-35784,0,,17892,35784,0
-17928,-35856,0,,17928,35856,0
-17964,-35928,0,,17964,35928,0
-18000,-36000,0,,18000,36000,0
-18036,-36072,0,,18036,36072,0
-18072,-36144,0,,18072,36144,0
-18108,-36216,0,,18108,36216,0
-18144,-36288,0,,18144,36288,0
-18180,-36360,0,,18180,36360,0
-18216,-36432,0,,18216,36432,0
-18252,-36504,0,,18252,36504,0
-18288,-36576,0,,18288,36576,0
-18324,-36648,0,,18324,36648,0
-18360,-36720,0,,18360,36720,0
-18396,-36792,0,,18396,36792,0
-18432,-36864,0,,18432,36864,0
-18468,-36936,0,,18468,36936,0
-18504,-37008,0,,18504,37008,0
-18540,-37080,0,,18540,37080,0
-18576,-37152,0,,18576,37152,0
-18612,-37224,0,,18612,37224,0
-18648,-37296,0,,18648,37296,0
-18684,-37368,0,,18684,37368,0
-18720,-37440,0,,18720,37440,0
-18756,-37512,0,,18756,37512,0
-18792,-37584,0,,18792,37584,0
-18828,-37656,0,,18828,37656,0
-18864,-37728,0,,18864,37728,0
-18900,-37800,0,,18900,37800,0
-18936,-37872,0,,18936,37872,0
-18972,-37944,0,,18972,37944,0
-19008,-38016,0,,19008,38016,0
-19044,-38088,0,,19044,38088,0
-19080,-38160,0,,19080,38160,0
-19116,-38232,0,,19116,38232,0
-19152,-38304,0,,19152,38304,0
-19188,-38376,0,,19188,38376,0
-19224,-38448,0,,19224,38448,0
-19260,-38520,0,,19260,38520,0
-19296,-38592,0,,19296,38592,0
-19332,-38664,0,,19332,38664,0
-19368,-38736,0,,19368,38736,0
-19404,-38808,0,,19404,38808,0
-19440,-38880,0,,19440,38880,0
-19476,-38952,0,,19476,38952,0
-19512,-39024,0,,19512,39024,0
-19548,-39096,0,,19548,39096,0
-19584,-39168,0,,19584,39168,0
-19620,-39240,0,,19620,39240,0
-19656,-39312,0,,19656,39312,0
-19692,-39384,0,,19692,39384,0
-19728,-39456,0,,19728,39456,0
-19764,-39528,0,,19764,39528,0
-19800,-39600,0,,19800,39600,0
-19836,-39672,0,,19836,39672,0
-19872,-39744,0,,19872,39744,0
-19908,-39816,0,,19908,39816,0
-19944,-39888,0,,19944,39888,0
-19980,-39960,0,,19980,39960,0
-20016,-40032,0,,20016,40032,0
-20052,-40104,0,,20052,40104,0
-20088,-40176,0,,20088,40176,0
-20124,-40248,0,,20124,40248,0
-20160,-40320,0,,20160,40320,0
-20196,-40392,0,,20196,40392,0
-20232,-40464,0,,20232,40464,0
-20268,-40536,0,,20268,40536,0
-20304,-40608,0,,20304,40608,0
-20340,-40680,0,,20340,40680,0
-20376,-40752,0,,20376,40752,0
-20412,-40824,0,,20412,40824,0
-20448,-40896,0,,20448,40896,0
-20484,-40968,0,,20484,40968,0
-20520,-41040,0,,20520,41040,0
-20556,-41112,0,,20556,41112,0
-20592,-41184,0,,20592,41184,0
-20628,-41256,0,,20628,41256,0
-20664,-41328,0,,20664,41328,0
-20700,-41400,0,,20700,41400,0
-20736,-41472,0,,20736,41472,0
-20772,-41544,0,,20772,41544,0
-20808,-41616,0,,20808,41616,0
-20844,-41688,0,,20844,41688,0
-20880,-41760,0,,20880,41760,0
-20916,-41832,0,,20916,41832,0
-20952,-41904,0,,20952,41904,0
-20988,-41976,0,,20988,41976,0
-21024,-42048,0,,21024,42048,0
-21060,-42120,0,,21060,42120,0
-21096,-42192,0,,21096,42192,0
-21132,-42264,0,,21132,42264,0
-21168,-42336,0,,21168,42336,0
-21204,-42408,0,,21204,42408,0
-21240,-42480,0,,21240,42480,0
-21276,-42552,0,,21276,42552,0
-21312,-42624,0,,21312,42624,0
-21348,-42696,0,,21348,42696,0
-21384,-42768,0,,21384,42768,0
-21420,-42840,0,,21420,42840,0
-21456,-42912,0,,21456,42912,0
-21492,-42984,0,,21492,42984,0
-21528,-43056,0,,21528,43056,0
-21564,-43128,0,,21564,43128,0
-21600,-43200,0,,21600,43200,0
-21636,-43272,0,,21636,43272,0
-21672,-43344,0,,21672,43344,0
-21708,-43416,0,,21708,43416,0
-21744,-43488,0,,21744,43488,0
-21780,-43560,0,,21780,43560,0
-21816,-43632,0,,21816,43632,0
-21852,-43704,0,,21852,43704,0
-21888,-43776,0,,21888,43776,0
-21924,-43848,0,,21924,43848,0
-21960,-43920,0,,21960,43920,0
-21996,-43992,0,,21996,43992,0
-22032,-44064,0,,22032,44064,0
-22068,-44136,0,,22068,44136,0
-22104,-44208,0,,22104,44208,0
-22140,-44280,0,,22140,44280,0
-22176,-44352,0,,22176,44352,0
-22212,-44424,0,,22212,44424,0
-22248,-44496,0,,22248,44496,0
-22284,-44568,0,,22284,44568,0
-22320,-44640,0,,22320,44640,0
-22356,-44712,0,,22356,44712,0
-22392,-44784,0,,22392,44784,0
-22428,-44856,0,,22428,44856,0
-22464,-44928,0,,22464,44928,0
-22500,-45000,0,,22500,45000,0
-22536,-45072,0,,22536,45072,0
-22572,-45144,0,,22572,45144,0
-22608,-45216,0,,22608,45216,0
-22644,-45288,0,,22644,45288,0
-22680,-45360,0,,22680,45360,0
-22716,-45432,0,,22716,45432,0
-22752,-45504,0,,22752,45504,0
-22788,-45576,0,,22788,45576,0
-22824,-45648,0,,22824,45648,0
-22860,-45720,0,,22860,45720,0
-22896,-45792,0,,22896,45792,0
-22932,-45864,0,,22932,45864,0
-22968,-45936,0,,22968,45936,0
-23004,-46008,0,,23004,46008,0
-23040,-46080,0,,23040,46080,0
-23076,-46152,0,,23076,46152,0
-23112,-46224,0,,23112,46224,0
-23148,-46296,0,,23148,46296,0
-23184,-46368,0,,23184,46368,0
-23220,-46440,0,,23220,46440,0
-23256,-46512,0,,23256,46512,0
-23292,-46584,0,,23292,46584,0
-23328,-46656,0,,23328,46656,0
-23364,-46728,0,,23364,46728,0
-23400,-46800,0,,23400,46800,0
-23436,-46872,0,,23436,46872,0
-23472,-46944,0,,23472,46944,0
-23508,-47016,0,,23508,47016,0
-23544,-47088,0,,23544,47088,0
-23580,-47160,0,,23580,47160,0
-23616,-47232,0,,23616,47232,0
-23652,-47304,0,,23652,47304,0
-23688,-47376,0,,23688,47376,0
-23724,-47448,0,,23724,47448,0
-23760,-47520,0,,23760,47520,0
-23796,-47592,0,,23796,47592,0
-23832,-47664,0,,23832,47664,0
-23868,-47736,0,,23868,47736,0
-23904,-47808,0,,23904,47808,0
-23940,-47880,0,,23940,47880,0
-23976,-47952,0,,23976,47952,0
-24012,-48024,0,,24012,48024,0
-24048,-48096,0,,24048,48096,0
-24084,-48168,0,,24084,48168,0
-24120,-48240,0,,24120,48240,0
-24156,-48312,0,,24156,48312,0
-24192,-48384,0,,24192,48384,0
-24228,-48456,0,,24228,48456,0
-24264,-48528,0,,24264,48528,0
-24300,-48600,0,,24300,48600,0
-24336,-48672,0,,24336,48672,0
-24372,-48744,0,,24372,48744,0
-24408,-48816,0,,24408,48816,0
-24444,-48888,0,,24444,48888,0
-24480,-48960,0,,24480,48960,0
-24516,-49032,0,,24516,49032,0
-24552,-49104,0,,24552,49104,0
-24588,-49176,0,,24588,49176,0
-24624,-49248,0,,24624,49248,0
-24660,-49320,0,,24660,49320,0
-24696,-49392,0,,24696,49392,0
-24732,-49464,0,,24732,49464,0
-24768,-49536,0,,24768,49536,0
-24804,-49608,0,,24804,49608,0
-24840,-49680,0,,24840,49680,0
-24876,-49752,0,,24876,49752,0
-24912,-49824,0,,24912,49824,0
-24948,-49896,0,,24948,49896,0
-24984,-49968,0,,24984,49968,0
-25020,-50040,0,,25020,50040,0
-25056,-50112,0,,25056,50112,0
-25092,-50184,0,,25092,50184,0
-25128,-50256,0,,25128,50256,0
-25164,-50328,0,,25164,50328,0
-25200,-50400,0,,25200,50400,0
-25236,-50472,0,,25236,50472,0
-25272,-50544,0,,25272,50544,0
-25308,-50616,0,,25308,50616,0
-25344,-50688,0,,25344,50688,0
-25380,-50760,0,,25380,50760,0
-25416,-50832,0,,25416,50832,0
-25452,-50904,0,,25452,50904,0
-25488,-50976,0,,25488,50976,0
-25524,-51048,0,,25524,51048,0
-25560,-51120,0,,25560,51120,0
-25596,-51192,0,,25596,51192,0
-25632,-51264,0,,25632,51264,0
-25668,-51336,0,,25668,51336,0
-25704,-51408,0,,25704,51408,0
-25740,-51480,0,,25740,51480,0
-25776,-51552,0,,25776,51552,0
-25812,-51624,0,,25812,51624,0
-25848,-51696,0,,25848,51696,0
-25884,-51768,0,,25884,51768,0
-25920,-51840,0,,25920,51840,0
-25956,-51912,0,,25956,51912,0
-25992,-51984,0,,25992,51984,0
-26028,-52056,0,,26028,52056,0
-26064,-52128,0,,26064,52128,0
-26100,-52200,0,,26100,52200,0
-26136,-52272,0,,26136,52272,0
-26172,-52344,0,,26172,52344,0
-26208,-52416,0,,26208,52416,0
-26244,-52488,0,,26244,52488,0
-26280,-52560,0,,26280,52560,0
-26316,-52632,0,,26316,52632,0
-26352,-52704,0,,26352,52704,0
-26388,-52776,0,,26388,52776,0
-26424,-52848,0,,26424,52848,0
-26460,-52920,0,,26460,52920,0
-26496,-52992,0,,26496,52992,0
-26532,-53064,0,,26532,53064,0
-26568,-53136,0,,26568,53136,0
-26604,-53208,0,,26604,53208,0
-26640,-53280,0,,26640,53280,0
-26676,-53352,0,,26676,53352,0
-26712,-53424,0,,26712,53424,0
-26748,-53496,0,,26748,53496,0
-26784,-53568,0,,26784,53568,0
-26820,-53640,0,,26820,53640,0
-26856,-53712,0,,26856,53712,0
-26892,-53784,0,,26892,53784,0
-26928,-53856,0,,26928,53856,0
-26964,-53928,0,,26964,53928,0
-27000,-54000,0,,27000,54000,0
-27036,-54072,0,,27036,54072,0
-27072,-54144,0,,27072,54144,0
-27108,-54216,0,,27108,54216,0
-27144,-54288,0,,27144,54288,0
-27180,-54360,0,,27180,54360,0
-27216,-54432,0,,27216,54432,0
-27252,-54504,0,,27252,54504,0
-27288,-54576,0,,27288,54576,0
-27324,-54648,0,,27324,54648,0
-27360,-54720,0,,27360,54720,0
-27396,-54792,0,,27396,54792,0
-27432,-54864,0,,27432,54864,0
-27468,-54936,0,,27468,54936,0
-27504,-55008,0,,27504,55008,0
-27540,-55080,0,,27540,55080,0
-27576,-55152,0,,27576,55152,0
-27612,-55224,0,,27612,55224,0
-27648,-55296,0,,27648,55296,0
-27684,-55368,0,,27684,55368,0
-27720,-55440,0,,27720,55440,0
-27756,-55512,0,,27756,55512,0
-27792,-55584,0,,27792,55584,0
-27828,-55656,0,,27828,55656,0
-27864,-55728,0,,27864,55728,0
-27900,-55800,0,,27900,55800,0
-27936,-55872,0,,27936,55872,0
-27972,-55944,0,,27972,55944,0
-28008,-56016,0,,28008,56016,0
-28044,-56088,0,,28044,56088,0
-28080,-56160,0,,28080,56160,0
-28116,-56232,0,,28116,56232,0
-28152,-56304,0,,28152,56304,0
-28188,-56376,0,,28188,56376,0
-28224,-56448,0,,28224,56448,0
-28260,-56520,0,,28260,56520,0
-28296,-56592,0,,28296,56592,0
-28332,-56664,0,,28332,56664,0
-28368,-56736,0,,28368,56736,0
-28404,-56808,0,,28404,56808,0
-28440,-56880,0,,28440,56880,0
-28476,-56952,0,,28476,56952,0
-28512,-57024,0,,28512,57024,0
-28548,-57096,0,,28548,57096,0
-28584,-57168,0,,28584,57168,0
-28620,-57240,0,,28620,57240,0
-28656,-57312,0,,28656,57312,0
-28692,-57384,0,,28692,57384,0
-28728,-57456,0,,28728,57456,0
-28764,-57528,0,,28764,57528,0
-28800,-57600,0,,28800,57600,0
-28836,-57672,0,,28836,57672,0
-28872,-57744,0,,28872,57744,0
-28908,-57816,0,,28908,57816,0
-28944,-57888,0,,28944,57888,0
-28980,-57960,0,,28980,57960,0
-29016,-58032,0,,29016,58032,0
-29052,-58104,0,,29052,58104,0
-29088,-58176,0,,29088,58176,0
-29124,-58248,0,,29124,58248,0
-29160,-58320,0,,29160,58320,0
-29196,-58392,0,,29196,58392,0
-29232,-58464,0,,29232,58464,0
-29268,-58536,0,,29268,58536,0
-29304,-58608,0,,29304,58608,0
-29340,-58680,0,,29340,58680,0
-29376,-58752,0,,29376,58752,0
-29412,-58824,0,,29412,58824,0
-29448,-58896,0,,29448,58896,0
-29484,-58968,0,,29484,58968,0
-29520,-59040,0,,29520,59040,0
-29556,-59112,0,,29556,59112,0
-29592,-59184,0,,29592,59184,0
-29628,-59256,0,,29628,59256,0
-29664,-59328,0,,29664,59328,0
-29700,-59400,0,,29700,59400,0
-29736,-59472,0,,29736,59472,0
-29772,-59544,0,,29772,59544,0
-29808,-59616,0,,29808,59616,0
-29844,-59688,0,,29844,59688,0
-29880,-59760,0,,29880,59760,0
-29916,-59832,0,,29916,59832,0
-29952,-59904,0,,29952,59904,0
-29988,-59976,0,,29988,59976,0
-30024,-60048,0,,30024,60048,0
-30060,-60120,0,,30060,60120,0
-30096,-60192,0,,30096,60192,0
-30132,-60264,0,,30132,60264,0
-30168,-60336,0,,30168,60336,0
-30204,-60408,0,,30204,60408,0
-30240,-60480,0,,30240,60480,0
-30276,-60552,0,,30276,60552,0
-30312,-60624,0,,30312,60624,0
-30348,-60696,0,,30348,60696,0
-30384,-60768,0,,30384,60768,0
-30420,-60840,0,,30420,60840,0
-30456,-60912,0,,30456,60912,0
-30492,-60984,0,,30492,60984,0
-30528,-61056,0,,30528,61056,0
-30564,-61128,0,,30564,61128,0
-30600,-61200,0,,30600,61200,0
-30636,-61272,0,,30636,61272,0
-30672,-61344,0,,30672,61344,0
-30708,-61416,0,,30708,61416,0
-30744,-61488,0,,30744,61488,0
-30780,-61560,0,,30780,61560,0
-30816,-61632,0,,30816,61632,0
-30852,-61704,0,,30852,61704,0
-30888,-61776,0,,30888,61776,0
-30924,-61848,0,,30924,61848,0
-30960,-61920,0,,30960,61920,0
-30996,-61992,0,,30996,61992,0
-31032,-62064,0,,31032,62064,0
-31068,-62136,0,,31068,62136,0
-31104,-62208,0,,31104,62208,0
-31140,-62280,0,,31140,62280,0
-31176,-62352,0,,31176,62352,0
-31212,-62424,0,,31212,62424,0
-31248,-62496,0,,31248,62496,0
-31284,-62568,0,,31284,62568,0
-31320,-62640,0,,31320,62640,0
-31356,-62712,0,,31356,62712,0
-31392,-62784,0,,31392,62784,0
-31428,-62856,0,,31428,62856,0
-31464,-62928,0,,31464,62928,0
-31500,-63000,0,,31500,63000,0
-31536,-63072,0,,31536,63072,0
-31572,-63144,0,,31572,63144,0
-31608,-63216,0,,31608,63216,0
-31644,-63288,0,,31644,63288,0
-31680,-63360,0,,31680,63360,0
-31716,-63432,0,,31716,63432,0
-31752,-63504,0,,31752,63504,0
-31788,-63576,0,,31788,63576,0
-31824,-63648,0,,31824,63648,0
-31860,-63720,0,,31860,63720,0
-31896,-63792,0,,31896,63792,0
-31932,-63864,0,,31932,63864,0
-31968,-63936,0,,31968,63936,0
-32004,-64008,0,,32004,64008,0
-32040,-64080,0,,32040,64080,0
-32076,-64152,0,,32076,64152,0
-32112,-64224,0,,32112,64224,0
-32148,-64296,0,,32148,64296,0
-32184,-64368,0,,32184,64368,0
-32220,-64440,0,,32220,64440,0
-32256,-64512,0,,32256,64512,0
-32292,-64584,0,,32292,64584,0
-32328,-64656,0,,32328,64656,0
-32364,-64728,0,,32364,64728,0
-32400,-64800,0,,32400,64800,0
-32436,-64872,0,,32436,64872,0
-32472,-64944,0,,32472,64944,0
-32508,-65016,0,,32508,65016,0
-32544,-65088,0,,32544,65088,0
-32580,-65160,0,,32580,65160,0
-32616,-65232,0,,32616,65232,0
-32652,-65304,0,,32652,65304,0
-32688,-65376,0,,32688,65376,0
-32724,-65448,0,,32724,65448,0
-32760,-65520,0,,32760,65520,0
-32796,-65592,0,,32796,65592,0
-32832,-65664,0,,32832,65664,0
-32868,-65736,0,,32868,65736,0
-32904,-65808,0,,32904,65808,0
-32940,-65880,0,,32940,65880,0
-32976,-65952,0,,32976,65952,0
-33012,-66024,0,,33012,66024,0
-33048,-66096,0,,33048,66096,0
-33084,-66168,0,,33084,66168,0
-33120,-66240,0,,33120,66240,0
-33156,-66312,0,,33156,66312,0
-33192,-66384,0,,33192,66384,0
-33228,-66456,0,,33228,66456,0
-33264,-66528,0,,33264,66528,0
-33300,-66600,0,,33300,66600,0
-33336,-66672,0,,33336,66672,0
-33372,-66744,0,,33372,66744,0
-33408,-66816,0,,33408,66816,0
-33444,-66888,0,,33444,66888,0
-33480,-66960,0,,33480,66960,0
-33516,-67032,0,,33516,67032,0
-33552,-67104,0,,33552,67104,0
-33588,-67176,0,,33588,67176,0
-33624,-67248,0,,33624,67248,0
-33660,-67320,0,,33660,67320,0
-33696,-67392,0,,33696,67392,0
-33732,-67464,0,,33732,67464,0
-33768,-67536,0,,33768,67536,0
-33804,-67608,0,,33804,67608,0
-33840,-67680,0,,33840,67680,0
-33876,-67752,0,,33876,67752,0
-33912,-67824,0,,33912,67824,0
-33948,-67896,0,,33948,67896,0
-33984,-67968,0,,33984,67968,0
-34020,-68040,0,,34020,68040,0
-34056,-68112,0,,34056,68112,0
-34092,-68184,0,,34092,68184,0
-34128,-68256,0,,34128,68256,0
-34164,-68328,0,,34164,68328,0
-34200,-68400,0,,34200,68400,0
-34236,-68472,0,,34236,68472,0
-34272,-68544,0,,34272,68544,0
-34308,-68616,0,,34308,68616,0
-34344,-68688,0,,34344,68688,0
-34380,-68760,0,,34380,68760,0
-34416,-68832,0,,34416,68832,0
-34452,-68904,0,,34452,68904,0
-34488,-68976,0,,34488,68976,0
-34524,-69048,0,,34524,69048,0
-34560,-69120,0,,34560,69120,0
-34596,-69192,0,,34596,69192,0
-34632,-69264,0,,34632,69264,0
-34668,-69336,0,,34668,69336,0
-34704,-69408,0,,34704,69408,0
-34740,-69480,0,,34740,69480,0
-34776,-69552,0,,34776,69552,0
-34812,-69624,0,,34812,69624,0
-34848,-69696,0,,34848,69696,0
-34884,-69768,0,,34884,69768,0
-34920,-69840,0,,34920,69840,0
-34956,-69912,0,,34956,69912,0
-34992,-69984,0,,34992,69984,0
-35028,-70056,0,,35028,70056,0
-35064,-70128,0,,35064,70128,0
-35100,-70200,0,,35100,70200,0
-35136,-70272,0,,35136,70272,0
-35172,-70344,0,,35172,70344,0
-35208,-70416,0,,35208,70416,0
-35244,-70488,0,,35244,70488,0
-35280,-70560,0,,35280,70560,0
-35316,-70632,0,,35316,70632,0
-35352,-70704,0,,35352,70704,0
-35388,-70776,0,,35388,70776,0
-35424,-70848,0,,35424,70848,0
-35460,-70920,0,,35460,70920,0
-35496,-70992,0,,35496,70992,0
-35532,-71064,0,,35532,71064,0
-35568,-71136,0,,35568,71136,0
-35604,-71208,0,,35604,71208,0
-35640,-71280,0,,35640,71280,0
-35676,-71352,0,,35676,71352,0
-35712,-71424,0,,35712,71424,0
-35748,-71496,0,,35748,71496,0
-35784,-71568,0,,35784,71568,0
-35820,-71640,0,,35820,71640,0
-35856,-71712,0,,35856,71712,0
-35892,-71784,0,,35892,71784,0
-35928,-71856,0,,35928,71856,0
-35964,-71928,0,,35964,71928,0
-36000,-72000,0,,36000,72000,0
-36036,-72072,0,,36036,72072,0
-36072,-72144,0,,36072,72144,0
-36108,-72216,0,,36108,72216,0
-36144,-72288,0,,36144,72288,0
-36180,-72360,0,,36180,72360,0
-36216,-72432,0,,36216,72432,0
-36252,-72504,0,,36252,72504,0
-36288,-72576,0,,36288,72576,0
-36324,-72648,0,,36324,72648,0
-36360,-72720,0,,36360,72720,0
-36396,-72792,0,,36396,72792,0
-36432,-72864,0,,36432,72864,0
-36468,-72936,0,,36468,72936,0
-36504,-73008,0,,36504,73008,0
-36540,-73080,0,,36540,73080,0
-36576,-73152,0,,36576,73152,0
-36612,-73224,0,,36612,73224,0
-36648,-73296,0,,36648,73296,0
-36684,-73368,0,,36684,73368,0
-36720,-73440,0,,36720,73440,0
-36756,-73512,0,,36756,73512,0
-36792,-73584,0,,36792,73584,0
-36828,-73656,0,,36828,73656,0
-36864,-73728,0,,36864,73728,0
-36900,-73800,0,,36900,73800,0
-36936,-73872,0,,36936,73872,0
-36972,-73944,0,,36972,73944,0
-37008,-74016,0,,37008,74016,0
-37044,-74088,0,,37044,74088,0
-37080,-74160,0,,37080,74160,0
-37116,-74232,0,,37116,74232,0
-37152,-74304,0,,37152,74304,0
-37188,-74376,0,,37188,74376,0
-37224,-74448,0,,37224,74448,0
-37260,-74520,0,,37260,74520,0
-37296,-74592,0,,37296,74592,0
-37332,-74664,0,,37332,74664,0
-37368,-74736,0,,37368,74736,0
-37404,-74808,0,,37404,74808,0
-37440,-74880,0,,37440,74880,0
-37476,-74952,0,,37476,74952,0
-37512,-75024,0,,37512,75024,0
-37548,-75096,0,,37548,75096,0
-37584,-75168,0,,37584,75168,0
-37620,-75240,0,,37620,75240,0
-37656,-75312,0,,37656,75312,0
-37692,-75384,0,,37692,75384,0
-37728,-75456,0,,37728,75456,0
-37764,-75528,0,,37764,75528,0
-37800,-75600,0,,37800,75600,0
-37836,-75672,0,,37836,75672,0
-37872,-75744,0,,37872,75744,0
-37908,-75816,0,,37908,75816,0
-37944,-75888,0,,37944,75888,0
-37980,-75960,0,,37980,75960,0
-38016,-76032,0,,38016,76032,0
-38052,-76104,0,,38052,76104,0
-38088,-76176,0,,38088,76176,0
-38124,-76248,0,,38124,76248,0
-38160,-76320,0,,38160,76320,0
-38196,-76392,0,,38196,76392,0
-38232,-76464,0,,38232,76464,0
-38268,-76536,0,,38268,76536,0
-38304,-76608,0,,38304,76608,0
-38340,-76680,0,,38340,76680,0
-38376,-76752,0,,38376,76752,0
-38412,-76824,0,,38412,76824,0
-38448,-76896,0,,38448,76896,0
-38484,-76968,0,,38484,76968,0
-38520,-77040,0,,38520,77040,0
-38556,-77112,0,,38556,77112,0
-38592,-77184,0,,38592,77184,0
-38628,-77256,0,,38628,77256,0
-38664,-77328,0,,38664,77328,0
-38700,-77400,0,,38700,77400,0
-38736,-77472,0,,38736,77472,0
-38772,-77544,0,,38772,77544,0
-38808,-77616,0,,38808,77616,0
-38844,-77688,0,,38844,77688,0
-38880,-77760,0,,38880,77760,0
-38916,-77832,0,,38916,77832,0
-38952,-77904,0,,38952,77904,0
-38988,-77976,0,,38988,77976,0
-39024,-78048,0,,39024,78048,0
-39060,-78120,0,,39060,78120,0
-39096,-78192,0,,39096,78192,0
-39132,-78264,0,,39132,78264,0
-39168,-78336,0,,39168,78336,0
-39204,-78408,0,,39204,78408,0
-39240,-78480,0,,39240,78480,0
-39276,-78552,0,,39276,78552,0
-39312,-78624,0,,39312,78624,0
-39348,-78696,0,,39348,78696,0
-39384,-78768,0,,39384,78768,0
-39420,-78840,0,,39420,78840,0
-39456,-78912,0,,39456,78912,0
-39492,-78984,0,,39492,78984,0
-39528,-79056,0,,39528,79056,0
-39564,-79128,0,,39564,79128,0
-39600,-79200,0,,39600,79200,0
-39636,-79272,0,,39636,79272,0
-39672,-79344,0,,39672,79344,0
-39708,-79416,0,,39708,79416,0
-39744,-79488,0,,39744,79488,0
-39780,-79560,0,,39780,79560,0
-39816,-79632,0,,39816,79632,0
-39852,-79704,0,,39852,79704,0
-39888,-79776,0,,39888,79776,0
-39924,-79848,0,,39924,79848,0
-39960,-79920,0,,39960,79920,0
-39996,-79992,0,,39996,79992,0
-40032,-80064,0,,40032,80064,0
-40068,-80136,0,,40068,80136,0
-40104,-80208,0,,40104,80208,0
-40140,-80280,0,,40140,80280,0
-40176,-80352,0,,40176,80352,0
-40212,-80424,0,,40212,80424,0
-40248,-80496,0,,40248,80496,0
-40284,-80568,0,,40284,80568,0
-40320,-80640,0,,40320,80640,0
-40356,-80712,0,,40356,80712,0
-40392,-80784,0,,40392,80784,0
-40428,-80856,0,,40428,80856,0
-40464,-80928,0,,40464,80928,0
-40500,-81000,0,,40500,81000,0
-40536,-81072,0,,40536,81072,0
-40572,-81144,0,,40572,81144,0
-40608,-81216,0,,40608,81216,0
-40644,-81288,0,,40644,81288,0
-40680,-81360,0,,40680,81360,0
-40716,-81432,0,,40716,81432,0
-40752,-81504,0,,40752,81504,0
-40788,-81576,0,,40788,81576,0
-40824,-81648,0,,40824,81648,0
-40860,-81720,0,,40860,81720,0
-40896,-81792,0,,40896,81792,0
-40932,-81864,0,,40932,81864,0
-40968,-81936,0,,40968,81936,0
-41004,-82008,0,,41004,82008,0
-41040,-82080,0,,41040,82080,0
-41076,-82152,0,,41076,82152,0
-41112,-82224,0,,41112,82224,0
-41148,-82296,0,,41148,82296,0
-41184,-82368,0,,41184,82368,0
-41220,-82440,0,,41220,82440,0
-41256,-82512,0,,41256,82512,0
-41292,-82584,0,,41292,82584,0
-41328,-82656,0,,41328,82656,0
-41364,-82728,0,,41364,82728,0
-41400,-82800,0,,41400,82800,0
-41436,-82872,0,,41436,82872,0
-41472,-82944,0,,41472,82944,0
-41508,-83016,0,,41508,83016,0
-41544,-83088,0,,41544,83088,0
-41580,-83160,0,,41580,83160,0
-41616,-83232,0,,41616,83232,0
-41652,-83304,0,,41652,83304,0
-41688,-83376,0,,41688,83376,0
-41724,-83448,0,,41724,83448,0
-41760,-83520,0,,41760,83520,0
-41796,-83592,0,,41796,83592,0
-41832,-83664,0,,41832,83664,0
-41868,-83736,0,,41868,83736,0
-41904,-83808,0,,41904,83808,0
-41940,-83880,0,,41940,83880,0
-41976,-83952,0,,41976,83952,0
-42012,-84024,0,,42012,84024,0
-42048,-84096,0,,42048,84096,0
-42084,-84168,0,,42084,84168,0
-42120,-84240,0,,42120,84240,0
-42156,-84312,0,,42156,84312,0
-42192,-84384,0,,42192,84384,0
-42228,-84456,0,,42228,84456,0
-42264,-84528,0,,42264,84528,0
-42300,-84600,0,,42300,84600,0
-42336,-84672,0,,42336,84672,0
-42372,-84744,0,,42372,84744,0
-42408,-84816,0,,42408,84816,0
-42444,-84888,0,,42444,84888,0
-42480,-84960,0,,42480,84960,0
-42516,-85032,0,,42516,85032,0
-42552,-85104,0,,42552,85104,0
-42588,-85176,0,,42588,85176,0
-42624,-85248,0,,42624,85248,0
-42660,-85320,0,,42660,85320,0
-42696,-85392,0,,42696,85392,0
-42732,-85464,0,,42732,85464,0
-42768,-85536,0,,42768,85536,0
-42804,-85608,0,,42804,85608,0
-42840,-85680,0,,42840,85680,0
-42876,-85752,0,,42876,85752,0
-42912,-85824,0,,42912,85824,0
-42948,-85896,0,,42948,85896,0
-42984,-85968,0,,42984,85968,0
-43020,-86040,0,,43020,86040,0
-43056,-86112,0,,43056,86112,0
-43092,-86184,0,,43092,86184,0
-43128,-86256,0,,43128,86256,0
-43164,-86328,0,,43164,86328,0
-43200,-86400,0,,43200,86400,0
